ふと目が覚めると、妙に股間がもどかしい…	眼睛睜開時、突然感覺到股間有種奇妙的感覺#朝騎乘位
下半身に目をやると、%CALLNAME:ARG%が%CALLNAME:MASTER%のペニスから溢れ出す先走り汁をペロペロと舐め取っていた…	看了看下半身、%CALLNAME:ARG%在舔%CALLNAME:MASTER%的陰莖流出來的先走汁……
「あ、%CNAMET(ARG, "二人称")%…おはようございます……」	「啊、%CNAMET(ARG, "二人称")%…早上好……」
「%CNAMET(ARG, "二人称")%がなかなかおきてくれないので、%CNAMET(ARG, "二人称")%のおちんちんであそんでました……」	「%CNAMET(ARG, "二人称")%一直不起來、就先跟%CNAMET(ARG, "二人称")%的雞雞玩了……」」
%CALLNAME:ARG%は微笑みながら両手で%CALLNAME:MASTER%のペニスを激しく扱くと、あと少しというところで動きを止めてしまった…	%CALLNAME:ARG%は一邊微笑一邊用手幫%CALLNAME:MASTER%の手淫、但在即將要射精之前便停下了手…
「こうやってびくびくーってなると、おちんちんからヌルヌルがいっぱい出てきます……」	「如果雞雞這樣抖動的話、就會射出很多喔……」
"「ふふ…%CNAMET(ARG, "一人称")%とおそろいですね……_BHH_」_W"	"「哈哈…跟%CNAMET(ARG, "一人称")%是一對的呢……_BHH_」_W"
%CALLNAME:ARG%は%CALLNAME:MASTER%の股間の上に跨ると、%CALLNAME:MASTER%見せ付けるように%TEXTR("小さな/幼い")%%TEXTR("膣/性器")%をくぱぁと開いた…	%CALLNAME:ARG%跨坐在%CALLNAME:MASTER%的股間上、%CALLNAME:MASTER%像是要刻意被看見地、將%TEXTR("小小的/幼稚的")%%TEXTR("膣/性器")%撥開…
ヒクつく%TEXTR("膣口/膣穴")%からドロリと愛液が垂れ落ち、%CALLNAME:MASTER%のペニスをドロドロにしていく……	顫抖著的%TEXTR("膣口/膣穴")%不斷地流出黏稠地愛液、弄濕了%CALLNAME:MASTER%的陰莖……
「%CNAMET(ARG, "二人称", "どもり")%はもうガマンできないですよね…？」	「%CNAMET(ARG, "二人称", "どもり")%已經忍不住喽…？」
「%CNAMET(ARG, "二人称")%がどっちでも…%CNAMET(ARG, "一人称")%がもうガマンできないです……」	「%CNAMET(ARG, "二人称")%…%CNAMET(ARG, "一人称")%已經不行了……」
"「%CNAMET(ARG, "二人称")%の%TEXTR("せーし/せーし/せーえき/おちんちんみるく")%…%CNAMET(ARG, "一人称")%の%TEXTR("しきゅー/しきゅー/おまんこ")%に%TEXTR("いっぱい/たっぷり/たくさん")%%TEXTR("のませて/のませて/のませて/ビュービューして/ドピュドピュして/ぶっコイて/むだうちして")%ください……_BHH_」_W"	"「把%CNAMET(ARG, "二人称")%的%TEXTR("精子/精子/精液/肉棒牛奶")%…注入%CNAMET(ARG, "一人称")%的%TEXTR("子宮/子宮/小穴")%記得要%TEXTR("多到溢出來地/全部/多一點")%%TEXTR("讓我喝/讓我喝/讓我喝/射出來/射出來/毫無忌憚地射出來/直到弄壞為止")%喔……_BHH_」_W"
%CALLNAME:ARG%は%TEXTR("小さな/幼い")%%TEXTR("膣/性器")%を広げたまま腰を下ろすと、見せ付けるようにペニスをヌルっと一気に咥えこんだ…	%CALLNAME:ARG%把%TEXTR("小小的/幼稚的")%的%TEXTR("膣/性器")%張開並坐下、像是要刻意被看見地、將陰莖一口吞下…
膣奥を刺激される感覚に惚けた表情をする%CALLNAME:ARG%は、そのまま子宮口に打ち付けるように腰を跳ねさせている…	膣內被刺激的感覚讓%CALLNAME:ARG%做出恍惚的表情、之後突然動起了腰使陰莖撞擊子宮口…
どぷっ！どぷるるるっ！どぱっ！どぴゅるるるっ！どぴゅっ！	啪！啪！啪！啪啪啪！啪啪！
寝てる間に焦らされていた%CALLNAME:MASTER%は、懸命にしがみつく%CALLNAME:ARG%の幼膣の刺激に少しも耐えることができずに	%CALLNAME:ARG%的小穴用力吸住%CALLNAME:MASTER%的陰莖、使%CALLNAME:MASTER%再也忍不住
情けない声を漏らしながら、%CALLNAME:ARG%の子宮に吸われるままにたっぷりと精を吐き出した…	漏出不成樣子的呻吟、%CALLNAME:ARG%在子宮射出了精液…	
"「あっ！_BHH_  あっ！_BHH_  %CNAMET(ARG, "一人称", "かな")%もぉっ！_BHH_BHH_  イきっ！_BHH_  イっちゃっ！_BHH_」_W"	"「啊！_BHH_  啊！_BHH_  %CNAMET(ARG, "一人称", "かな")%要！_BHH_BHH_  要！_BHH_  要去啦！_BHH_」_W"
"「うう゛ぅううぅっ！！_BHH_BHH_BHH_」_W"	"「嗚゛嗚嗚嗚！！_BHH_BHH_BHH_」_W"
子宮に精液を注がれる感覚で絶頂した%CALLNAME:ARG%は、一段と力強く腰を震わせながら潮を撒き散らした…	%CALLNAME:ARG%因為子宮被精液充滿的感覚而絕頂、腰部痙攣了一陣子後、潮吹了…
結合部からは精液があまり漏れ出ておらず、%CALLNAME:ARG%の下腹部が明らかにポッコリと膨れ上がっている…	從兩人結合的地方沒流出什麼精液而%CALLNAME:ARG%下腹部明顯地膨脹了起來…
"「%CNAMET(ARG, "二人称")%のがいっぱいです…えへへ……_BHH_」_W"	"「%CNAMET(ARG, "二人称")%的精液好多啊…嘿嘿……_BHH_」_W"
「もうすこしだけ…このままでいてくれませんか……？」	「在一下下啦…可以在溫存一下嗎……？」
%CALLNAME:ARG%は\@ MARK:ARG:淫紋 > 1 ? 精を注がれてチカチカと光る淫紋 	摸了摸%CALLNAME:ARG%\@ MARK:ARG:淫紋 > 1 ? 因為被精液充滿而閃閃發亮的淫紋 
朝、目が覚めると妙に下腹部が暖かい…	眼睛睜開時、突然感覺到股間有股熱流
目をやると%CALLNAME:ARG%が上に跨って喘いでいる……	睜眼之後、%CALLNAME:ARG%跨坐在我的上面嬌喘……
%CALLNAME:ARG%は後ろ手を付いて、%CALLNAME:MASTER%のペニスを自分のキモチイイ場所に擦り付けるたびに


